12 7
- #      #  
-###    ### 
#   #  #   #
#i i#  #i i#
-           
I         O 
############
