13 7
- #       #  
-###     ### 
#   #   #   #
#i i#   #i i#
-            
I     i    O 
#############
